 #   # #   #   #   #   # #   ##### # # # # # # # # # # # # # # # # # # # # #  
 #   # #   #   #   #   # #   ##### # # # # # # # # # # # # # # # # # # # # #  
 #   # #   #####   #   ####  ####################################### # # # #  
X                                                                             
 #   # #   #   #####   ####  ##### # # # # # # # # # # ################### #  
 #   # #   #   #   #   # #   ##### # # # # # # # # # # # # # # # # # # # # #  
 #   # #   #   #   #   # #   ##### # # # # # # # # # # # # # # # # # # # # #  